bbbbbbbbbbbbbbbbbbbbbbbbbbbbbbbb
bS     S   b   S   bS         Sb
bS         b       b  E    E   b
bbbb   S   S   S   S           b
bS     b       b               b
bbb    b   S   b   S  E    E   b
b      S   b   bbbbb           b
b          b   b   S           b
b  b   S   b   b               b
b  b   b   b   b   S  E    E   b
bS b   b   bS Sb   b           b
bbbb   b   bbbbbS Sb           b
b      b   S       b  E    E   b
b 0    b           b           b
b      b           b           b
bbbbbbbbbbbbbbbbbbbbbbbbbbbbbbbb